50.ox
.o..........o....oo.ooo....................oo.....
.................o.oo.......o.............o..o...o
....o.....o...o..o.o.....o.....o....o..o..oo......
o....o.....o........o.......ooo....oo.oo.....o...o
.....oo..o.........o....o.o...........oo.oo.......
.....o...o....o..o.o....o.....o....o..o..........o
...o......oo.......o..............o..o..........o.
o..o.ooo......o..o.........................oo.....
...oo..o..o..ooo..ooo........o.........oo.....o.o.
.........oo......o.oo..ooo............o...........
....ooo.....o..o.o....o...o............o.....o....
.....o........o..o...............o......oo........
.........o...o.......o.o.o....o.oo...o...oo.....o.
...oo...o...o.o......o.o.o.......o.........o...o..
..o....o..o..........oo...........................
.oo.......o...........oo....oo................o..o
...o.....o....o......o.........o..o..o...oo.o.....
.......o......o............o...o..........oo...o..
oo....oo...o.oo......o..o......o.....oo...o.......
..o.....oo........o...............o....o.o........
....o..........o.oo...o...............o......o....
o.......o.o.o.....o.o.................o.o..o..o...
.o..oo...........o.............................o..
..o.............ooo..o...o..o...o....o......oo....
........o..o.........o.....ooo....o.o..o..oo.o...o
oo..o.o......o.............o.o.........ooo........
......o......o.....o....oo........o...oo.........o
....o....o..o..o.o......o....o.o....o...o.o.......
o..o......o.........o..o............o.....o.......
o......o.o..o..o.o...o....oo.o..................oo
.............o.o..o..o.........ooo..o..o...o......
..o..........oo.....o.oooo..o.......o..ooo........
......o...............o.......o...o....oo.........
..ooo..o..o.....o.o.o..o.oo.o..oo.........oo......
.oo..oo...o...........oo......o......o.o..........
..o......o.......o.ooo..........o.......oo........
...........o.....o....o.........ooo....o...o.....o
oo......o.......o......................o..o..o....
........oo.....o.......o........o.....ooo.....o..o
...ooo..oo..........o...o...o.......o.o..o.o......
....o..oo...o........o....................o....o..
o..o.....o..o.........o.o.o.oo....o...o.....o....o
.o...o.......o..o...........ooo.o......o......oo..
...o.......o.........o.o.o..oo..oo..o...oo......o.
...o.....oooo.oooo.......o......o.................
.........o........................o.oo......o.....
..oo................o.....o.o.o.o.o.o.o.o..oo.....
o..o.....o..........o..oo.ooo....o......o.........
..o.......o....o...o....o...o......o...o.....o....
..o...ooo.o.o..o....o..........o....o............o
